NO textures/test/north.xpm
SO textures/test/south.xpm
WE textures/test/west.xpm
EA textures/test/east.xpm

F 20,20,20
C 200,200,200

     1111111111111111111
     1000000000000000001
111111100000000000000001
111111101111111111111001
111111101111111111111001
111111101111111111111001
111111101111111111111001
111111101111111111111001
100000001          11001
100E00001          11001
100000001          11001
111111111          11111